## ===============================================##
##  TonguExpert Databese
##  Version 1.0 
##  Last Update at Apr 26 2024
##  https://www.biosino.org/TonguExpert
## ===============================================##
##  ===== Folder hierarchy ===== ## 
##  TonguExpertDatabase/
##  ├── Phenotypes/
##  │   ├── L1_Labels_Manual.txt
##  │   ├── L2_Labels_Predict.txt
##  │   ├── P11_Tg_Color.txt
##  │   ├── P12_Tg_Shape.txt
##  │   ├── P13_Tg_Texture.txt
##  │   ├── P14_Tg_CNN.txt
##  │   ├── P2*_Tai_*.txt
##  │   ├── P3*_Zhi_*.txt
##  │   ├── P4*_Fissure_*.txt
##  │   └── P5*_Toothmark_*.txt
##  ├── TongueImage/
##  │   ├── Raw/
##  │   └── Mask/
##  └── README.txt
## ===== Colname ===== ##
Colname	Description
SID	Sample ID
tai_Red1	Color feature - Red Component Frequency in Interval 1 of tongue coating
tai_Red2	Color feature - Red Component Frequency in Interval 2 of tongue coating
tai_Red3	Color feature - Red Component Frequency in Interval 3 of tongue coating
tai_Red4	Color feature - Red Component Frequency in Interval 4 of tongue coating
tai_Red5	Color feature - Red Component Frequency in Interval 5 of tongue coating
tai_Green1	Color feature - Green Component Frequency in Interval 1 of tongue coating
tai_Green2	Color feature - Green Component Frequency in Interval 2 of tongue coating
tai_Green3	Color feature - Green Component Frequency in Interval 3 of tongue coating
tai_Green4	Color feature - Green Component Frequency in Interval 4 of tongue coating
tai_Green5	Color feature - Green Component Frequency in Interval 5 of tongue coating
tai_Blue1	Color feature - Blue Component Frequency in Interval 1 of tongue coating
tai_Blue2	Color feature - Blue Component Frequency in Interval 2 of tongue coating
tai_Blue3	Color feature - Blue Component Frequency in Interval 3 of tongue coating
tai_Blue4	Color feature - Blue Component Frequency in Interval 4 of tongue coating
tai_Blue5	Color feature - Blue Component Frequency in Interval 5 of tongue coating
tai_L1	Color feature - Luminance Value Frequency in Interval 1 of tongue coating
tai_L2	Color feature - Luminance Value Frequency in Interval 2 of tongue coating
tai_L3	Color feature - Luminance Value Frequency in Interval 3 of tongue coating
tai_L4	Color feature - Luminance Value Frequency in Interval 4 of tongue coating
tai_L5	Color feature - Luminance Value Frequency in Interval 5 of tongue coating
tai_a3	Color feature - a Value Frequency in Interval 3 of tongue coating
tai_a4	Color feature - a Value Frequency in Interval 4 of tongue coating
tai_b3	Color feature - b Value Frequency in Interval 3 of tongue coating
tai_H1	Color feature - Hue Value Frequency in Interval 1 of tongue coating
tai_H2	Color feature - Hue Value Frequency in Interval 2 of tongue coating
tai_H3	Color feature - Hue Value Frequency in Interval 3 of tongue coating
tai_H4	Color feature - Hue Value Frequency in Interval 4 of tongue coating
tai_S1	Color feature - Saturation Value Frequency in Interval 1 of tongue coating
tai_S2	Color feature - Saturation Value Frequency in Interval 2 of tongue coating
tai_S3	Color feature - Saturation Value Frequency in Interval 3 of tongue coating
tai_V1	Color feature - V Value Frequency in Interval 1 of tongue coating
tai_V2	Color feature - V Value Frequency in Interval 2 of tongue coating
tai_V3	Color feature - V Value Frequency in Interval 3 of tongue coating
tai_V4	Color feature - V Value Frequency in Interval 4 of tongue coating
tai_V5	Color feature - V Value Frequency in Interval 5 of tongue coating
tai_Gray1	Color feature - Grayscale Value Frequency in Interval 1 of tongue coating
tai_Gray2	Color feature - Grayscale Value Frequency in Interval 2 of tongue coating
tai_Gray3	Color feature - Grayscale Value Frequency in Interval 3 of tongue coating
tai_Gray4	Color feature - Grayscale Value Frequency in Interval 4 of tongue coating
tai_Gray5	Color feature - Grayscale Value Frequency in Interval 5 of tongue coating
tai_Red_mid	Color feature - Median of Red Component of tongue coating
tai_Red_avg	Color feature - Mean of Red Component of tongue coating
tai_Red_var	Color feature - Variance of Red Component of tongue coating
tai_Red_skew	Color feature - Skewness of Red Component of tongue coating
tai_Green_mid	Color feature - Median of Green Component of tongue coating
tai_Green_avg	Color feature - Mean of Green Component of tongue coating
tai_Green_var	Color feature - Variance of Green Component of tongue coating
tai_Green_skew	Color feature - Skewness of Green Component of tongue coating
tai_Blue_mid	Color feature - Median of Blue Component of tongue coating
tai_Blue_avg	Color feature - Mean of Blue Component of tongue coating
tai_Blue_var	Color feature - Variance of Blue Component of tongue coating
tai_Blue_skew	Color feature - Skewness of Blue Component of tongue coating
tai_L_mid	Color feature - Median of Luminance Value of tongue coating
tai_L_avg	Color feature - Mean of Luminance Value of tongue coating
tai_L_var	Color feature - Variance of Luminance Value of tongue coating
tai_L_skew	Color feature - Skewness of Luminance Value of tongue coating
tai_a_mid	Color feature - Median of a Value of tongue coating
tai_a_avg	Color feature - Mean of a Value of tongue coating
tai_a_var	Color feature - Variance of a Value of tongue coating
tai_a_skew	Color feature - Skewness of a Value of tongue coating
tai_b_mid	Color feature - Median of b Value of tongue coating
tai_b_avg	Color feature - Mean of b Value of tongue coating
tai_b_var	Color feature - Variance of b Value of tongue coating
tai_b_skew	Color feature - Skewness of b Value of tongue coating
tai_H_mid	Color feature - Median of H Value of tongue coating
tai_H_avg	Color feature - Mean of H Value of tongue coating
tai_H_var	Color feature - Variance of H Value of tongue coating
tai_H_skew	Color feature - Skewness of H Value of tongue coating
tai_S_mid	Color feature - Median of Saturation Value of tongue coating
tai_S_avg	Color feature - Mean of Saturation Value of tongue coating
tai_S_var	Color feature - Variance of Saturation Value of tongue coating
tai_S_skew	Color feature - Skewness of Saturation Value of tongue coating
tai_V_mid	Color feature - Median of V Value of tongue coating
tai_V_avg	Color feature - Mean of V Value of tongue coating
tai_V_var	Color feature - Variance of V Value of tongue coating
tai_V_skew	Color feature - Skewness of V Value of tongue coating
tai_gray_mid	Color feature - Median of Grayscale Value of tongue coating
tai_gray_avg	Color feature - Mean of Grayscale Value of tongue coating
tai_gray_var	Color feature - Variance of Grayscale Value of tongue coating
tai_gray_skew	Color feature - Skewness of Grayscale Value of tongue coating
zhi_Red1	Color feature - Red Component Frequency in Interval 1 of tongue body
zhi_Red2	Color feature - Red Component Frequency in Interval 2 of tongue body
zhi_Red3	Color feature - Red Component Frequency in Interval 3 of tongue body
zhi_Red4	Color feature - Red Component Frequency in Interval 4 of tongue body
zhi_Red5	Color feature - Red Component Frequency in Interval 5 of tongue body
zhi_Green1	Color feature - Green Component Frequency in Interval 1 of tongue body
zhi_Green2	Color feature - Green Component Frequency in Interval 2 of tongue body
zhi_Green3	Color feature - Green Component Frequency in Interval 3 of tongue body
zhi_Green4	Color feature - Green Component Frequency in Interval 4 of tongue body
zhi_Green5	Color feature - Green Component Frequency in Interval 5 of tongue body
zhi_Blue1	Color feature - Blue Component Frequency in Interval 1 of tongue body
zhi_Blue2	Color feature - Blue Component Frequency in Interval 2 of tongue body
zhi_Blue3	Color feature - Blue Component Frequency in Interval 3 of tongue body
zhi_Blue4	Color feature - Blue Component Frequency in Interval 4 of tongue body
zhi_Blue5	Color feature - Blue Component Frequency in Interval 5 of tongue body
zhi_L1	Color feature - Luminance Value Frequency in Interval 1 of tongue body
zhi_L2	Color feature - Luminance Value Frequency in Interval 2 of tongue body
zhi_L3	Color feature - Luminance Value Frequency in Interval 3 of tongue body
zhi_L4	Color feature - Luminance Value Frequency in Interval 4 of tongue body
zhi_L5	Color feature - Luminance Value Frequency in Interval 5 of tongue body
zhi_a3	Color feature - a Value Frequency in Interval 3 of tongue body
zhi_a4	Color feature - a Value Frequency in Interval 4 of tongue body
zhi_b3	Color feature - b Value Frequency in Interval 3 of tongue body
zhi_H1	Color feature - Hue Value Frequency in Interval 1 of tongue body
zhi_H2	Color feature - Hue Value Frequency in Interval 2 of tongue body
zhi_H3	Color feature - Hue Value Frequency in Interval 3 of tongue body
zhi_H4	Color feature - Hue Value Frequency in Interval 4 of tongue body
zhi_S1	Color feature - Saturation Value Frequency in Interval 1 of tongue body
zhi_S2	Color feature - Saturation Value Frequency in Interval 2 of tongue body
zhi_S3	Color feature - Saturation Value Frequency in Interval 3 of tongue body
zhi_S4	Color feature - Saturation Value Frequency in Interval 4 of tongue body
zhi_V1	Color feature - V Value Frequency in Interval 1 of tongue body
zhi_V2	Color feature - V Value Frequency in Interval 2 of tongue body
zhi_V3	Color feature - V Value Frequency in Interval 3 of tongue body
zhi_V4	Color feature - V Value Frequency in Interval 4 of tongue body
zhi_V5	Color feature - V Value Frequency in Interval 5 of tongue body
zhi_Gray1	Color feature - Grayscale Value Frequency in Interval 1 of tongue body
zhi_Gray2	Color feature - Grayscale Value Frequency in Interval 2 of tongue body
zhi_Gray3	Color feature - Grayscale Value Frequency in Interval 3 of tongue body
zhi_Gray4	Color feature - Grayscale Value Frequency in Interval 4 of tongue body
zhi_Gray5	Color feature - Grayscale Value Frequency in Interval 5 of tongue body
zhi_Red_mid	Color feature - Median of Red Component of tongue body
zhi_Red_avg	Color feature - Mean of Red Component of tongue body
zhi_Red_var	Color feature - Variance of Red Component of tongue body
zhi_Red_skew	Color feature - Skewness of Red Component of tongue body
zhi_Green_mid	Color feature - Median of Green Component of tongue body
zhi_Green_avg	Color feature - Mean of Green Component of tongue body
zhi_Green_var	Color feature - Variance of Green Component of tongue body
zhi_Green_skew	Color feature - Skewness of Green Component of tongue body
zhi_Blue_mid	Color feature - Median of Blue Component of tongue body
zhi_Blue_avg	Color feature - Mean of Blue Component of tongue body
zhi_Blue_var	Color feature - Variance of Blue Component of tongue body
zhi_Blue_skew	Color feature - Skewness of Blue Component of tongue body
zhi_L_mid	Color feature - Median of Luminance Value of tongue body
zhi_L_avg	Color feature - Mean of Luminance Value of tongue body
zhi_L_var	Color feature - Variance of Luminance Value of tongue body
zhi_L_skew	Color feature - Skewness of Luminance Value of tongue body
zhi_a_mid	Color feature - Median of a Value of tongue body
zhi_a_avg	Color feature - Mean of a Value of tongue body
zhi_a_var	Color feature - Variance of a Value of tongue body
zhi_a_skew	Color feature - Skewness of a Value of tongue body
zhi_b_mid	Color feature - Median of b Value of tongue body
zhi_b_avg	Color feature - Mean of b Value of tongue body
zhi_b_var	Color feature - Variance of b Value of tongue body
zhi_b_skew	Color feature - Skewness of b Value of tongue body
zhi_H_mid	Color feature - Median of H Value of tongue body
zhi_H_avg	Color feature - Mean of H Value of tongue body
zhi_H_var	Color feature - Variance of H Value of tongue body
zhi_H_skew	Color feature - Skewness of H Value of tongue body
zhi_S_mid	Color feature - Median of Saturation Value of tongue body
zhi_S_avg	Color feature - Mean of Saturation Value of tongue body
zhi_S_var	Color feature - Variance of Saturation Value of tongue body
zhi_S_skew	Color feature - Skewness of Saturation Value of tongue body
zhi_V_mid	Color feature - Median of V Value of tongue body
zhi_V_avg	Color feature - Mean of V Value of tongue body
zhi_V_var	Color feature - Variance of V Value of tongue body
zhi_V_skew	Color feature - Skewness of V Value of tongue body
zhi_gray_mid	Color feature - Median of Grayscale Value of tongue body
zhi_gray_avg	Color feature - Mean of Grayscale Value of tongue body
zhi_gray_var	Color feature - Variance of Grayscale Value of tongue body
zhi_gray_skew	Color feature - Skewness of Grayscale Value of tongue body
tg_Red1	Color feature - Red Component Frequency in Interval 1 of entire tongue
tg_Red2	Color feature - Red Component Frequency in Interval 2 of entire tongue
tg_Red3	Color feature - Red Component Frequency in Interval 3 of entire tongue
tg_Red4	Color feature - Red Component Frequency in Interval 4 of entire tongue
tg_Green1	Color feature - Green Component Frequency in Interval 1 of entire tongue
tg_Green2	Color feature - Green Component Frequency in Interval 2 of entire tongue
tg_Green3	Color feature - Green Component Frequency in Interval 3 of entire tongue
tg_Green4	Color feature - Green Component Frequency in Interval 4 of entire tongue
tg_Blue1	Color feature - Blue Component Frequency in Interval 1 of entire tongue
tg_Blue2	Color feature - Blue Component Frequency in Interval 2 of entire tongue
tg_Blue3	Color feature - Blue Component Frequency in Interval 3 of entire tongue
tg_Blue4	Color feature - Blue Component Frequency in Interval 4 of entire tongue
tg_Blue5	Color feature - Blue Component Frequency in Interval 5 of entire tongue
tg_L1	Color feature - Luminance Value Frequency in Interval 1 of entire tongue
tg_L2	Color feature - Luminance Value Frequency in Interval 2 of entire tongue
tg_L3	Color feature - Luminance Value Frequency in Interval 3 of entire tongue
tg_L4	Color feature - Luminance Value Frequency in Interval 4 of entire tongue
tg_L5	Color feature - Luminance Value Frequency in Interval 5 of entire tongue
tg_a3	Color feature - a Value Frequency in Interval 3 of entire tongue
tg_a4	Color feature - a Value Frequency in Interval 4 of entire tongue
tg_b3	Color feature - b Value Frequency in Interval 3 of entire tongue
tg_H1	Color feature - Hue Value Frequency in Interval 1 of entire tongue
tg_H4	Color feature - Hue Value Frequency in Interval 4 of entire tongue
tg_S1	Color feature - Saturation Value Frequency in Interval 1 of entire tongue
tg_S2	Color feature - Saturation Value Frequency in Interval 2 of entire tongue
tg_S3	Color feature - Saturation Value Frequency in Interval 3 of entire tongue
tg_S4	Color feature - Saturation Value Frequency in Interval 4 of entire tongue
tg_V1	Color feature - V Value Frequency in Interval 1 of entire tongue
tg_V2	Color feature - V Value Frequency in Interval 2 of entire tongue
tg_V3	Color feature - V Value Frequency in Interval 3 of entire tongue
tg_V4	Color feature - V Value Frequency in Interval 4 of entire tongue
tg_V5	Color feature - V Value Frequency in Interval 5 of entire tongue
tg_Gray1	Color feature - Grayscale Value Frequency in Interval 1 of entire tongue
tg_Gray2	Color feature - Grayscale Value Frequency in Interval 2 of entire tongue
tg_Gray3	Color feature - Grayscale Value Frequency in Interval 3 of entire tongue
tg_Gray4	Color feature - Grayscale Value Frequency in Interval 4 of entire tongue
tg_Red_mid	Color feature - Median of Red Component of entire tongue
tg_Red_avg	Color feature - Mean of Red Component of entire tongue
tg_Red_var	Color feature - Variance of Red Component of entire tongue
tg_Red_skew	Color feature - Skewness of Red Component of entire tongue
tg_Green_mid	Color feature - Median of Green Component of entire tongue
tg_Green_avg	Color feature - Mean of Green Component of entire tongue
tg_Green_var	Color feature - Variance of Green Component of entire tongue
tg_Green_skew	Color feature - Skewness of Green Component of entire tongue
tg_Blue_mid	Color feature - Median of Blue Component of entire tongue
tg_Blue_avg	Color feature - Mean of Blue Component of entire tongue
tg_Blue_var	Color feature - Variance of Blue Component of entire tongue
tg_Blue_skew	Color feature - Skewness of Blue Component of entire tongue
tg_L_mid	Color feature - Median of Luminance Value of entire tongue
tg_L_avg	Color feature - Mean of Luminance Value of entire tongue
tg_L_var	Color feature - Variance of Luminance Value of entire tongue
tg_L_skew	Color feature - Skewness of Luminance Value of entire tongue
tg_a_mid	Color feature - Median of a Value of entire tongue
tg_a_avg	Color feature - Mean of a Value of entire tongue
tg_a_var	Color feature - Variance of a Value of entire tongue
tg_a_skew	Color feature - Skewness of a Value of entire tongue
tg_b_mid	Color feature - Median of b Value of entire tongue
tg_b_avg	Color feature - Mean of b Value of entire tongue
tg_b_var	Color feature - Variance of b Value of entire tongue
tg_b_skew	Color feature - Skewness of b Value of entire tongue
tg_H_mid	Color feature - Median of H Value of entire tongue
tg_H_avg	Color feature - Mean of H Value of entire tongue
tg_H_var	Color feature - Variance of H Value of entire tongue
tg_H_skew	Color feature - Skewness of H Value of entire tongue
tg_S_mid	Color feature - Median of Saturation Value of entire tongue
tg_S_avg	Color feature - Mean of Saturation Value of entire tongue
tg_S_var	Color feature - Variance of Saturation Value of entire tongue
tg_S_skew	Color feature - Skewness of Saturation Value of entire tongue
tg_V_mid	Color feature - Median of V Value of entire tongue
tg_V_avg	Color feature - Mean of V Value of entire tongue
tg_V_var	Color feature - Variance of V Value of entire tongue
tg_V_skew	Color feature - Skewness of V Value of entire tongue
tg_gray_mid	Color feature - Median of Grayscale Value of entire tongue
tg_gray_avg	Color feature - Mean of Grayscale Value of entire tongue
tg_gray_var	Color feature - Variance of Grayscale Value of entire tongue
tg_gray_skew	Color feature - Skewness of Grayscale Value of entire tongue
tai_div_zhi	Shape feature - Coating-to-Tonguebody-Area Ratio of tongue coating
num_tai	Shape feature - Area of tongue coating
tai_lbp1	Texture feature - LBP Feature Frequency in Interval 1 of tongue coating
tai_lbp2	Texture feature - LBP Feature Frequency in Interval 2 of tongue coating
tai_lbp3	Texture feature - LBP Feature Frequency in Interval 3 of tongue coating
tai_lbp4	Texture feature - LBP Feature Frequency in Interval 4 of tongue coating
tai_lbp5	Texture feature - LBP Feature Frequency in Interval 5 of tongue coating
tai_hog1	Texture feature - HOG Feature Frequency in Interval 1 of tongue coating
tai_hog2	Texture feature - HOG Feature Frequency in Interval 2 of tongue coating
tai_hog3	Texture feature - HOG Feature Frequency in Interval 3 of tongue coating
tai_hog4	Texture feature - HOG Feature Frequency in Interval 4 of tongue coating
tai_hog5	Texture feature - HOG Feature Frequency in Interval 5 of tongue coating
tai_contrast	Texture feature - Contrast of tongue coating
tai_dissimilarity	Texture feature - Dissimilarity of tongue coating
tai_homogeneity	Texture feature - Homogeneity of tongue coating
tai_energy	Texture feature - Energy of tongue coating
tai_correlation	Texture feature - Correlation of tongue coating
tai_entropy	Texture feature - Entropy of tongue coating
num_zhi	Shape feature - Area of tongue body
zhi_lbp1	Texture feature - LBP Feature Frequency in Interval 1 of tongue body
zhi_lbp2	Texture feature - LBP Feature Frequency in Interval 2 of tongue body
zhi_lbp3	Texture feature - LBP Feature Frequency in Interval 3 of tongue body
zhi_lbp4	Texture feature - LBP Feature Frequency in Interval 4 of tongue body
zhi_lbp5	Texture feature - LBP Feature Frequency in Interval 5 of tongue body
zhi_hog1	Texture feature - HOG Feature Frequency in Interval 1 of tongue body
zhi_hog2	Texture feature - HOG Feature Frequency in Interval 2 of tongue body
zhi_hog3	Texture feature - HOG Feature Frequency in Interval 3 of tongue body
zhi_hog4	Texture feature - HOG Feature Frequency in Interval 4 of tongue body
zhi_hog5	Texture feature - HOG Feature Frequency in Interval 5 of tongue body
zhi_contrast	Texture feature - Contrast of tongue body
zhi_dissimilarity	Texture feature - Dissimilarity of tongue body
zhi_homogeneity	Texture feature - Homogeneity of tongue body
zhi_energy	Texture feature - Energy of tongue body
zhi_correlation	Texture feature - Correlation of tongue body
zhi_entropy	Texture feature - Entropy of tongue body
num_tg	Shape feature - Area of entire tongue
tg_lbp1	Texture feature - LBP Feature Frequency in Interval 1 of entire tongue
tg_lbp2	Texture feature - LBP Feature Frequency in Interval 2 of entire tongue
tg_lbp3	Texture feature - LBP Feature Frequency in Interval 3 of entire tongue
tg_lbp4	Texture feature - LBP Feature Frequency in Interval 4 of entire tongue
tg_lbp5	Texture feature - LBP Feature Frequency in Interval 5 of entire tongue
tg_hog1	Texture feature - HOG Feature Frequency in Interval 1 of entire tongue
tg_hog2	Texture feature - HOG Feature Frequency in Interval 2 of entire tongue
tg_hog3	Texture feature - HOG Feature Frequency in Interval 3 of entire tongue
tg_hog4	Texture feature - HOG Feature Frequency in Interval 4 of entire tongue
tg_hog5	Texture feature - HOG Feature Frequency in Interval 5 of entire tongue
tg_contrast	Texture feature - Contrast of entire tongue
tg_dissimilarity	Texture feature - Dissimilarity of entire tongue
tg_homogeneity	Texture feature - Homogeneity of entire tongue
tg_energy	Texture feature - Energy of entire tongue
tg_correlation	Texture feature - Correlation of entire tongue
tg_entropy	Texture feature - Entropy of entire tongue
tg_width	Shape feature - Width of entire tongue
tg_height	Shape feature - Height of entire tongue
tg_w_div_h	Shape feature - Aspect Ratio of entire tongue
tai_cnnPC1	CNN feature - CNN Feature PC1 of tongue coating
tai_cnnPC2	CNN feature - CNN Feature PC2 of tongue coating
tai_cnnPC3	CNN feature - CNN Feature PC3 of tongue coating
tai_cnnPC4	CNN feature - CNN Feature PC4 of tongue coating
tai_cnnPC5	CNN feature - CNN Feature PC5 of tongue coating
tai_cnnPC6	CNN feature - CNN Feature PC6 of tongue coating
tai_cnnPC7	CNN feature - CNN Feature PC7 of tongue coating
tai_cnnPC8	CNN feature - CNN Feature PC8 of tongue coating
tai_cnnPC9	CNN feature - CNN Feature PC9 of tongue coating
tai_cnnPC10	CNN feature - CNN Feature PC10 of tongue coating
zhi_cnnPC1	CNN feature - CNN Feature PC1 of tongue body
zhi_cnnPC2	CNN feature - CNN Feature PC2 of tongue body
zhi_cnnPC3	CNN feature - CNN Feature PC3 of tongue body
zhi_cnnPC4	CNN feature - CNN Feature PC4 of tongue body
zhi_cnnPC5	CNN feature - CNN Feature PC5 of tongue body
zhi_cnnPC6	CNN feature - CNN Feature PC6 of tongue body
zhi_cnnPC7	CNN feature - CNN Feature PC7 of tongue body
zhi_cnnPC8	CNN feature - CNN Feature PC8 of tongue body
zhi_cnnPC9	CNN feature - CNN Feature PC9 of tongue body
zhi_cnnPC10	CNN feature - CNN Feature PC10 of tongue body
tg_cnnPC1	CNN feature - CNN Feature PC1 of entire tongue
tg_cnnPC2	CNN feature - CNN Feature PC2 of entire tongue
tg_cnnPC3	CNN feature - CNN Feature PC3 of entire tongue
tg_cnnPC4	CNN feature - CNN Feature PC4 of entire tongue
tg_cnnPC5	CNN feature - CNN Feature PC5 of entire tongue
tg_cnnPC6	CNN feature - CNN Feature PC6 of entire tongue
tg_cnnPC7	CNN feature - CNN Feature PC7 of entire tongue
tg_cnnPC8	CNN feature - CNN Feature PC8 of entire tongue
tg_cnnPC9	CNN feature - CNN Feature PC9 of entire tongue
tg_cnnPC10	CNN feature - CNN Feature PC10 of entire tongue
fissure_Red1	Color feature - Red Component Frequency in Interval 1 of tongue fissures
fissure_Red3	Color feature - Red Component Frequency in Interval 3 of tongue fissures
fissure_Red4	Color feature - Red Component Frequency in Interval 4 of tongue fissures
fissure_Green1	Color feature - Green Component Frequency in Interval 1 of tongue fissures
fissure_Green3	Color feature - Green Component Frequency in Interval 3 of tongue fissures
fissure_Green4	Color feature - Green Component Frequency in Interval 4 of tongue fissures
fissure_Blue1	Color feature - Blue Component Frequency in Interval 1 of tongue fissures
fissure_Blue3	Color feature - Blue Component Frequency in Interval 3 of tongue fissures
fissure_Blue4	Color feature - Blue Component Frequency in Interval 4 of tongue fissures
fissure_Blue5	Color feature - Blue Component Frequency in Interval 5 of tongue fissures
fissure_L1	Color feature - Luminance Value Frequency in Interval 1 of tongue fissures
fissure_L3	Color feature - Luminance Value Frequency in Interval 3 of tongue fissures
fissure_L4	Color feature - Luminance Value Frequency in Interval 4 of tongue fissures
fissure_a3	Color feature - a Value Frequency in Interval 3 of tongue fissures
fissure_a4	Color feature - a Value Frequency in Interval 4 of tongue fissures
fissure_b3	Color feature - b Value Frequency in Interval 3 of tongue fissures
fissure_H1	Color feature - Hue Value Frequency in Interval 1 of tongue fissures
fissure_H4	Color feature - Hue Value Frequency in Interval 4 of tongue fissures
fissure_S1	Color feature - Saturation Value Frequency in Interval 1 of tongue fissures
fissure_S2	Color feature - Saturation Value Frequency in Interval 2 of tongue fissures
fissure_S3	Color feature - Saturation Value Frequency in Interval 3 of tongue fissures
fissure_V1	Color feature - V Value Frequency in Interval 1 of tongue fissures
fissure_V3	Color feature - V Value Frequency in Interval 3 of tongue fissures
fissure_V4	Color feature - V Value Frequency in Interval 4 of tongue fissures
fissure_V5	Color feature - V Value Frequency in Interval 5 of tongue fissures
fissure_Gray1	Color feature - Grayscale Value Frequency in Interval 1 of tongue fissures
fissure_Gray3	Color feature - Grayscale Value Frequency in Interval 3 of tongue fissures
fissure_Gray4	Color feature - Grayscale Value Frequency in Interval 4 of tongue fissures
fissure_Red_mid	Color feature - Median of Red Component of tongue fissures
fissure_Red_avg	Color feature - Mean of Red Component of tongue fissures
fissure_Red_var	Color feature - Variance of Red Component of tongue fissures
fissure_Red_skew	Color feature - Skewness of Red Component of tongue fissures
fissure_Green_mid	Color feature - Median of Green Component of tongue fissures
fissure_Green_avg	Color feature - Mean of Green Component of tongue fissures
fissure_Green_var	Color feature - Variance of Green Component of tongue fissures
fissure_Green_skew	Color feature - Skewness of Green Component of tongue fissures
fissure_Blue_mid	Color feature - Median of Blue Component of tongue fissures
fissure_Blue_avg	Color feature - Mean of Blue Component of tongue fissures
fissure_Blue_var	Color feature - Variance of Blue Component of tongue fissures
fissure_Blue_skew	Color feature - Skewness of Blue Component of tongue fissures
fissure_L_mid	Color feature - Median of Luminance Value of tongue fissures
fissure_L_avg	Color feature - Mean of Luminance Value of tongue fissures
fissure_L_var	Color feature - Variance of Luminance Value of tongue fissures
fissure_L_skew	Color feature - Skewness of Luminance Value of tongue fissures
fissure_a_mid	Color feature - Median of a Value of tongue fissures
fissure_a_avg	Color feature - Mean of a Value of tongue fissures
fissure_a_var	Color feature - Variance of a Value of tongue fissures
fissure_a_skew	Color feature - Skewness of a Value of tongue fissures
fissure_b_mid	Color feature - Median of b Value of tongue fissures
fissure_b_avg	Color feature - Mean of b Value of tongue fissures
fissure_b_var	Color feature - Variance of b Value of tongue fissures
fissure_b_skew	Color feature - Skewness of b Value of tongue fissures
fissure_H_mid	Color feature - Median of H Value of tongue fissures
fissure_H_avg	Color feature - Mean of H Value of tongue fissures
fissure_H_var	Color feature - Variance of H Value of tongue fissures
fissure_H_skew	Color feature - Skewness of H Value of tongue fissures
fissure_S_mid	Color feature - Median of Saturation Value of tongue fissures
fissure_S_avg	Color feature - Mean of Saturation Value of tongue fissures
fissure_S_var	Color feature - Variance of Saturation Value of tongue fissures
fissure_S_skew	Color feature - Skewness of Saturation Value of tongue fissures
fissure_V_mid	Color feature - Median of V Value of tongue fissures
fissure_V_avg	Color feature - Mean of V Value of tongue fissures
fissure_V_var	Color feature - Variance of V Value of tongue fissures
fissure_V_skew	Color feature - Skewness of V Value of tongue fissures
fissure_gray_mid	Color feature - Median of Grayscale Value of tongue fissures
fissure_gray_avg	Color feature - Mean of Grayscale Value of tongue fissures
fissure_gray_var	Color feature - Variance of Grayscale Value of tongue fissures
fissure_gray_skew	Color feature - Skewness of Grayscale Value of tongue fissures
fissure_Red_mid_ratio	Color feature - Relative median of  Red Component of tongue fissures
fissure_Red_avg_ratio	Color feature - Relative Mean of  Red Component of tongue fissures
fissure_Red_var_ratio	Color feature - Relative Variance of Red Component of tongue fissures
fissure_Red_skew_ratio	Color feature - Relative Skewness of Red Component of tongue fissures
fissure_Green_mid_ratio	Color feature - Relative median of  Green Component of tongue fissures
fissure_Green_avg_ratio	Color feature - Relative Mean of  Green Component of tongue fissures
fissure_Green_var_ratio	Color feature - Relative Variance of Green Component of tongue fissures
fissure_Green_skew_ratio	Color feature - Relative Skewness of Green Component of tongue fissures
fissure_Blue_mid_ratio	Color feature - Relative median of  Blue Component of tongue fissures
fissure_Blue_avg_ratio	Color feature - Relative Mean of  Blue Component of tongue fissures
fissure_Blue_var_ratio	Color feature - Relative Variance of Blue Component of tongue fissures
fissure_Blue_skew_ratio	Color feature - Relative Skewness of Blue Component of tongue fissures
fissure_L_mid_ratio	Color feature - Relative median of  Luminance Value of tongue fissures
fissure_L_avg_ratio	Color feature - Relative Mean of  Luminance Value of tongue fissures
fissure_L_var_ratio	Color feature - Relative Variance of Luminance Value of tongue fissures
fissure_L_skew_ratio	Color feature - Relative Skewness of Luminance Value of tongue fissures
fissure_a_mid_ratio	Color feature - Relative median of  a Value of tongue fissures
fissure_a_avg_ratio	Color feature - Relative Mean of  a Value of tongue fissures
fissure_a_var_ratio	Color feature - Relative Variance of a Value of tongue fissures
fissure_a_skew_ratio	Color feature - Relative Skewness of a Value of tongue fissures
fissure_b_mid_ratio	Color feature - Relative median of  b Value of tongue fissures
fissure_b_avg_ratio	Color feature - Relative Mean of  b Value of tongue fissures
fissure_b_var_ratio	Color feature - Relative Variance of b Value of tongue fissures
fissure_b_skew_ratio	Color feature - Relative Skewness of b Value of tongue fissures
fissure_H_mid_ratio	Color feature - Relative median of  Hue Value of tongue fissures
fissure_H_avg_ratio	Color feature - Relative Mean of  Hue Value of tongue fissures
fissure_H_var_ratio	Color feature - Relative Variance of Hue Value of tongue fissures
fissure_H_skew_ratio	Color feature - Relative Skewness of of tongue fissures
fissure_S_mid_ratio	Color feature - Relative median of  Saturation Value of tongue fissures
fissure_S_avg_ratio	Color feature - Relative Mean of  Saturation Value of tongue fissures
fissure_S_var_ratio	Color feature - Relative Variance of Saturation Value of tongue fissures
fissure_S_skew_ratio	Color feature - Relative Skewness of Saturation Value of tongue fissures
fissure_V_mid_ratio	Color feature - Relative median of  V Value of tongue fissures
fissure_V_avg_ratio	Color feature - Relative Mean of  V Value of tongue fissures
fissure_V_var_ratio	Color feature - Relative Variance of V Value of tongue fissures
fissure_V_skew_ratio	Color feature - Relative Skewness of V Value of tongue fissures
fissure_gray_mid_ratio	Color feature - Relative median of  Grayscale Value of tongue fissures
fissure_gray_avg_ratio	Color feature - Relative Mean of  Grayscale Value of tongue fissures
fissure_gray_var_ratio	Color feature - Relative Variance of Grayscale Value of tongue fissures
fissure_gray_skew_ratio	Color feature - Relative Skewness of Grayscale Value of tongue fissures
fissure_lbp1	Texture feature - LBP Feature Frequency in Interval 1 of tongue fissures
fissure_lbp2	Texture feature - LBP Feature Frequency in Interval 2 of tongue fissures
fissure_lbp3	Texture feature - LBP Feature Frequency in Interval 3 of tongue fissures
fissure_lbp4	Texture feature - LBP Feature Frequency in Interval 4 of tongue fissures
fissure_lbp5	Texture feature - LBP Feature Frequency in Interval 5 of tongue fissures
fissure_hog1	Texture feature - HOG Feature Frequency in Interval 1 of tongue fissures
fissure_hog2	Texture feature - HOG Feature Frequency in Interval 2 of tongue fissures
fissure_hog3	Texture feature - HOG Feature Frequency in Interval 3 of tongue fissures
fissure_hog4	Texture feature - HOG Feature Frequency in Interval 4 of tongue fissures
fissure_hog5	Texture feature - HOG Feature Frequency in Interval 5 of tongue fissures
fissure_contrast	Texture feature - Contrast of tongue fissures
fissure_dissimilarity	Texture feature - Dissimilarity of tongue fissures
fissure_homogeneity	Texture feature - Homogeneity of tongue fissures
fissure_energy	Texture feature - Energy of tongue fissures
fissure_correlation	Texture feature - Correlation of tongue fissures
fissure_entropy	Texture feature - Entropy of tongue fissures
fissure_num	Shape feature - count of fissures
fissure_avgWidth	Shape feature - Mean of  Width of tongue fissures
fissure_avgWidth_rela	Shape feature - Mean of  Relative Width of tongue fissures
fissure_avgHeight	Shape feature - Mean of  Height of tongue fissures
fissure_avgHeight_rela	Shape feature - Mean of  Relative Height of tongue fissures
fissure_avgW_H	Shape feature - Mean of  Aspect Ratio of tongue fissures
fissure_avgDiagonal	Shape feature - Mean of  Diagonal Length of tongue fissures
fissure_avgArea	Shape feature - Mean of  Area of tongue fissures
fissure_avgArea_rela	Shape feature - Mean of  Relative Area of tongue fissures
fissure_varWidth	Shape feature - Variance of Width of tongue fissures
fissure_varWidth_rela	Shape feature - Variance of Relative Width of tongue fissures
fissure_varHeight	Shape feature - Variance of Height of tongue fissures
fissure_varHeight_rela	Shape feature - Variance of Relative Height of tongue fissures
fissure_varW_H	Shape feature - Variance of Aspect Ratio of tongue fissures
fissure_varDiagonal	Shape feature - Variance of Diagonal Length of tongue fissures
fissure_varArea	Shape feature - Variance of Area of tongue fissures
fissure_varArea_rela	Shape feature - Variance of Relative Area of tongue fissures
fissure_medianWidth	Shape feature - median of  Width of tongue fissures
fissure_medianWidth_rela	Shape feature - median of  Relative Aspect Ratio of tongue fissures
fissure_medianHeight	Shape feature - median of  Height of tongue fissures
fissure_medianHeight_rela	Shape feature - median of  Relative Height of tongue fissures
fissure_medianW_H	Shape feature - median of  Aspect Ratio of tongue fissures
fissure_medianDiagonal	Shape feature - median of  Diagonal Length of tongue fissures
fissure_medianArea	Shape feature - median of  Area of tongue fissures
fissure_medianArea_rela	Shape feature - median of  Relative Area of tongue fissures
fissure_maxWidth	Shape feature - Maximum Width of tongue fissures
fissure_maxWidth_rela	Shape feature - Maximum Relative Width of tongue fissures
fissure_maxHeight	Shape feature - Maximum Height of tongue fissures
fissure_maxHeight_rela	Shape feature - Maximum Relative Height of tongue fissures
fissure_maxW_H	Shape feature - Maximum Aspect Ratio of tongue fissures
fissure_maxDiagonal	Shape feature - Maximum Diagonal Length of tongue fissures
fissure_maxArea	Shape feature - Maximum Area of tongue fissures
fissure_maxArea_rela	Shape feature - Maximum Relative Area of tongue fissures
fissure_minWidth	Shape feature - Minimum Width of tongue fissures
fissure_minWidth_rela	Shape feature - Minimum Relative Width of tongue fissures
fissure_minHeight	Shape feature - Minimum Height of tongue fissures
fissure_minHeight_rela	Shape feature - Minimum Relative Height of tongue fissures
fissure_minW_H	Shape feature - Minimum Aspect Ratio of tongue fissures
fissure_minDiagonal	Shape feature - Minimum Diagonal Length of tongue fissures
fissure_minArea	Shape feature - Minimum Area of tongue fissures
fissure_minArea_rela	Shape feature - Minimum Relative Area of tongue fissures
fissure_sumWidth	Shape feature - Total Width Length of tongue fissures
fissure_sumWidth_rela	Shape feature - Total Relative Width Length of tongue fissures
fissure_sumHeight	Shape feature - Total Height Length of tongue fissures
fissure_sumHeight_rela	Shape feature - Total Relative Height Length of tongue fissures
fissure_sumDiagonal	Shape feature - Total Diagonal Length of tongue fissures
fissure_sumArea	Shape feature - Total Area of tongue fissures
fissure_sumArea_rela	Shape feature - Total Relative Area of tongue fissures
fissure_cnnPC1	CNN feature - CNN Feature PC1 of tongue fissures
fissure_cnnPC2	CNN feature - CNN Feature PC2 of tongue fissures
fissure_cnnPC3	CNN feature - CNN Feature PC3 of tongue fissures
fissure_cnnPC4	CNN feature - CNN Feature PC4 of tongue fissures
fissure_cnnPC5	CNN feature - CNN Feature PC5 of tongue fissures
fissure_cnnPC6	CNN feature - CNN Feature PC6 of tongue fissures
fissure_cnnPC7	CNN feature - CNN Feature PC7 of tongue fissures
fissure_cnnPC8	CNN feature - CNN Feature PC8 of tongue fissures
fissure_cnnPC9	CNN feature - CNN Feature PC9 of tongue fissures
fissure_cnnPC10	CNN feature - CNN Feature PC10 of tongue fissures
tooth_mk_Red1	Color feature - Red Component Frequency in Interval 1 of tooth marks
tooth_mk_Red2	Color feature - Red Component Frequency in Interval 2 of tooth marks
tooth_mk_Red3	Color feature - Red Component Frequency in Interval 3 of tooth marks
tooth_mk_Green1	Color feature - Green Component Frequency in Interval 1 of tooth marks
tooth_mk_Green2	Color feature - Green Component Frequency in Interval 2 of tooth marks
tooth_mk_Green3	Color feature - Green Component Frequency in Interval 3 of tooth marks
tooth_mk_Blue2	Color feature - Blue Component Frequency in Interval 2 of tooth marks
tooth_mk_Blue3	Color feature - Blue Component Frequency in Interval 3 of tooth marks
tooth_mk_Blue4	Color feature - Blue Component Frequency in Interval 4 of tooth marks
tooth_mk_Blue5	Color feature - Blue Component Frequency in Interval 5 of tooth marks
tooth_mk_L1	Color feature - Luminance Value Frequency in Interval 1 of tooth marks
tooth_mk_L2	Color feature - Luminance Value Frequency in Interval 2 of tooth marks
tooth_mk_L3	Color feature - Luminance Value Frequency in Interval 3 of tooth marks
tooth_mk_L4	Color feature - Luminance Value Frequency in Interval 4 of tooth marks
tooth_mk_a3	Color feature - a Value Frequency in Interval 3 of tooth marks
tooth_mk_a4	Color feature - a Value Frequency in Interval 4 of tooth marks
tooth_mk_b3	Color feature - b Value Frequency in Interval 3 of tooth marks
tooth_mk_H1	Color feature - Hue Value Frequency in Interval 1 of tooth marks
tooth_mk_H4	Color feature - Hue Value Frequency in Interval 4 of tooth marks
tooth_mk_S1	Color feature - Saturation Value Frequency in Interval 1 of tooth marks
tooth_mk_S2	Color feature - Saturation Value Frequency in Interval 2 of tooth marks
tooth_mk_S3	Color feature - Saturation Value Frequency in Interval 3 of tooth marks
tooth_mk_V2	Color feature - V Value Frequency in Interval 2 of tooth marks
tooth_mk_V3	Color feature - V Value Frequency in Interval 3 of tooth marks
tooth_mk_V4	Color feature - V Value Frequency in Interval 4 of tooth marks
tooth_mk_V5	Color feature - V Value Frequency in Interval 5 of tooth marks
tooth_mk_Gray1	Color feature - Grayscale Value Frequency in Interval 1 of tooth marks
tooth_mk_Gray2	Color feature - Grayscale Value Frequency in Interval 2 of tooth marks
tooth_mk_Gray3	Color feature - Grayscale Value Frequency in Interval 3 of tooth marks
tooth_mk_Gray4	Color feature - Grayscale Value Frequency in Interval 4 of tooth marks
tooth_mk_Red_mid	Color feature - Median of Red Component of tooth marks
tooth_mk_Red_avg	Color feature - Mean of Red Component of tooth marks
tooth_mk_Red_var	Color feature - Variance of Red Component of tooth marks
tooth_mk_Red_skew	Color feature - Skewness of Red Component of tooth marks
tooth_mk_Green_mid	Color feature - Median of Green Component of tooth marks
tooth_mk_Green_avg	Color feature - Mean of Green Component of tooth marks
tooth_mk_Green_var	Color feature - Variance of Green Component of tooth marks
tooth_mk_Green_skew	Color feature - Skewness of Green Component of tooth marks
tooth_mk_Blue_mid	Color feature - Median of Blue Component of tooth marks
tooth_mk_Blue_avg	Color feature - Mean of Blue Component of tooth marks
tooth_mk_Blue_var	Color feature - Variance of Blue Component of tooth marks
tooth_mk_Blue_skew	Color feature - Skewness of Blue Component of tooth marks
tooth_mk_L_mid	Color feature - Median of Luminance Value of tooth marks
tooth_mk_L_avg	Color feature - Mean of Luminance Value of tooth marks
tooth_mk_L_var	Color feature - Variance of Luminance Value of tooth marks
tooth_mk_L_skew	Color feature - Skewness of Luminance Value of tooth marks
tooth_mk_a_mid	Color feature - Median of a Value of tooth marks
tooth_mk_a_avg	Color feature - Mean of a Value of tooth marks
tooth_mk_a_var	Color feature - Variance of a Value of tooth marks
tooth_mk_a_skew	Color feature - Skewness of a Value of tooth marks
tooth_mk_b_mid	Color feature - Median of b Value of tooth marks
tooth_mk_b_avg	Color feature - Mean of b Value of tooth marks
tooth_mk_b_var	Color feature - Variance of b Value of tooth marks
tooth_mk_b_skew	Color feature - Skewness of b Value of tooth marks
tooth_mk_H_mid	Color feature - Median of H Value of tooth marks
tooth_mk_H_avg	Color feature - Mean of H Value of tooth marks
tooth_mk_H_var	Color feature - Variance of H Value of tooth marks
tooth_mk_H_skew	Color feature - Skewness of H Value of tooth marks
tooth_mk_S_mid	Color feature - Median of Saturation Value of tooth marks
tooth_mk_S_avg	Color feature - Mean of Saturation Value of tooth marks
tooth_mk_S_var	Color feature - Variance of Saturation Value of tooth marks
tooth_mk_S_skew	Color feature - Skewness of Saturation Value of tooth marks
tooth_mk_V_mid	Color feature - Median of V Value of tooth marks
tooth_mk_V_avg	Color feature - Mean of V Value of tooth marks
tooth_mk_V_var	Color feature - Variance of V Value of tooth marks
tooth_mk_V_skew	Color feature - Skewness of V Value of tooth marks
tooth_mk_gray_mid	Color feature - Median of Grayscale Value of tooth marks
tooth_mk_gray_avg	Color feature - Mean of Grayscale Value of tooth marks
tooth_mk_gray_var	Color feature - Variance of Grayscale Value of tooth marks
tooth_mk_gray_skew	Color feature - Skewness of Grayscale Value of tooth marks
tooth_mk_Red_mid_ratio	Color feature - Relative median of  Red Component of tooth marks
tooth_mk_Red_avg_ratio	Color feature - Relative Mean of  Red Component of tooth marks
tooth_mk_Red_var_ratio	Color feature - Relative Variance of Red Component of tooth marks
tooth_mk_Red_skew_ratio	Color feature - Relative Skewness of Red Component of tooth marks
tooth_mk_Green_mid_ratio	Color feature - Relative median of  Green Component of tooth marks
tooth_mk_Green_avg_ratio	Color feature - Relative Mean of  Green Component of tooth marks
tooth_mk_Green_var_ratio	Color feature - Relative Variance of Green Component of tooth marks
tooth_mk_Green_skew_ratio	Color feature - Relative Skewness of Green Component of tooth marks
tooth_mk_Blue_mid_ratio	Color feature - Relative median of  Blue Component of tooth marks
tooth_mk_Blue_avg_ratio	Color feature - Relative Mean of  Blue Component of tooth marks
tooth_mk_Blue_var_ratio	Color feature - Relative Variance of Blue Component of tooth marks
tooth_mk_Blue_skew_ratio	Color feature - Relative Skewness of Blue Component of tooth marks
tooth_mk_L_mid_ratio	Color feature - Relative median of  Luminance Value of tooth marks
tooth_mk_L_avg_ratio	Color feature - Relative Mean of  Luminance Value of tooth marks
tooth_mk_L_var_ratio	Color feature - Relative Variance of Luminance Value of tooth marks
tooth_mk_L_skew_ratio	Color feature - Relative Skewness of Luminance Value of tooth marks
tooth_mk_a_mid_ratio	Color feature - Relative median of  a Value of tooth marks
tooth_mk_a_avg_ratio	Color feature - Relative Mean of  a Value of tooth marks
tooth_mk_a_var_ratio	Color feature - Relative Variance of a Value of tooth marks
tooth_mk_a_skew_ratio	Color feature - Relative Skewness of a Value of tooth marks
tooth_mk_b_mid_ratio	Color feature - Relative median of  b Value of tooth marks
tooth_mk_b_avg_ratio	Color feature - Relative Mean of  b Value of tooth marks
tooth_mk_b_var_ratio	Color feature - Relative Variance of b Value of tooth marks
tooth_mk_b_skew_ratio	Color feature - Relative Skewness of b Value of tooth marks
tooth_mk_H_mid_ratio	Color feature - Relative median of  Hue Value of tooth marks
tooth_mk_H_avg_ratio	Color feature - Relative Mean of  Hue Value of tooth marks
tooth_mk_H_var_ratio	Color feature - Relative Variance of Hue Value of tooth marks
tooth_mk_H_skew_ratio	Color feature - Relative Skewness of of tooth marks
tooth_mk_S_mid_ratio	Color feature - Relative median of  Saturation Value of tooth marks
tooth_mk_S_avg_ratio	Color feature - Relative Mean of  Saturation Value of tooth marks
tooth_mk_S_var_ratio	Color feature - Relative Variance of Saturation Value of tooth marks
tooth_mk_S_skew_ratio	Color feature - Relative Skewness of Saturation Value of tooth marks
tooth_mk_V_mid_ratio	Color feature - Relative median of  V Value of tooth marks
tooth_mk_V_avg_ratio	Color feature - Relative Mean of  V Value of tooth marks
tooth_mk_V_var_ratio	Color feature - Relative Variance of V Value of tooth marks
tooth_mk_V_skew_ratio	Color feature - Relative Skewness of V Value of tooth marks
tooth_mk_gray_mid_ratio	Color feature - Relative median of  Grayscale Value of tooth marks
tooth_mk_gray_avg_ratio	Color feature - Relative Mean of  Grayscale Value of tooth marks
tooth_mk_gray_var_ratio	Color feature - Relative Variance of Grayscale Value of tooth marks
tooth_mk_gray_skew_ratio	Color feature - Relative Skewness of Grayscale Value of tooth marks
tooth_mk_lbp1	Texture feature - LBP Feature Frequency in Interval 1 of tooth marks
tooth_mk_lbp2	Texture feature - LBP Feature Frequency in Interval 2 of tooth marks
tooth_mk_lbp3	Texture feature - LBP Feature Frequency in Interval 3 of tooth marks
tooth_mk_lbp4	Texture feature - LBP Feature Frequency in Interval 4 of tooth marks
tooth_mk_lbp5	Texture feature - LBP Feature Frequency in Interval 5 of tooth marks
tooth_mk_hog1	Texture feature - HOG Feature Frequency in Interval 1 of tooth marks
tooth_mk_hog2	Texture feature - HOG Feature Frequency in Interval 2 of tooth marks
tooth_mk_hog3	Texture feature - HOG Feature Frequency in Interval 3 of tooth marks
tooth_mk_hog4	Texture feature - HOG Feature Frequency in Interval 4 of tooth marks
tooth_mk_hog5	Texture feature - HOG Feature Frequency in Interval 5 of tooth marks
tooth_mk_contrast	Texture feature - Contrast of tooth marks
tooth_mk_dissimilarity	Texture feature - Dissimilarity of tooth marks
tooth_mk_homogeneity	Texture feature - Homogeneity of tooth marks
tooth_mk_energy	Texture feature - Energy of tooth marks
tooth_mk_correlation	Texture feature - Correlation of tooth marks
tooth_mk_entropy	Texture feature - Entropy of tooth marks
tooth_mk_num	Shape feature - count of tooth marks
tooth_mk_avgWidth	Shape feature - Mean of  Width of tooth marks
tooth_mk_avgWidth_rela	Shape feature - Mean of  Relative Width of tooth marks
tooth_mk_avgHeight	Shape feature - Mean of  Height of tooth marks
tooth_mk_avgHeight_rela	Shape feature - Mean of  Relative Height of tooth marks
tooth_mk_avgW_H	Shape feature - Mean of  Aspect Ratio of tooth marks
tooth_mk_avgDiagonal	Shape feature - Mean of  Diagonal Length of tooth marks
tooth_mk_avgArea	Shape feature - Mean of  Area of tooth marks
tooth_mk_avgArea_rela	Shape feature - Mean of  Relative Area of tooth marks
tooth_mk_maxWidth	Shape feature - Maximum Width of tooth marks
tooth_mk_maxWidth_rela	Shape feature - Maximum Relative Width of tooth marks
tooth_mk_maxHeight	Shape feature - Maximum Height of tooth marks
tooth_mk_maxHeight_rela	Shape feature - Maximum Relative Height of tooth marks
tooth_mk_maxW_H	Shape feature - Maximum Aspect Ratio of tooth marks
tooth_mk_maxDiagonal	Shape feature - Maximum Diagonal Length of tooth marks
tooth_mk_maxArea	Shape feature - Maximum Area of tooth marks
tooth_mk_maxArea_rela	Shape feature - Maximum Relative Area of tooth marks
tooth_mk_minWidth	Shape feature - Minimum Width of tooth marks
tooth_mk_minWidth_rela	Shape feature - Minimum Relative Width of tooth marks
tooth_mk_minHeight	Shape feature - Minimum Height of tooth marks
tooth_mk_minHeight_rela	Shape feature - Minimum Relative Height of tooth marks
tooth_mk_minW_H	Shape feature - Minimum Aspect Ratio of tooth marks
tooth_mk_minDiagonal	Shape feature - Minimum Diagonal Length of tooth marks
tooth_mk_minArea	Shape feature - Minimum Area of tooth marks
tooth_mk_minArea_rela	Shape feature - Minimum Relative Area of tooth marks
tooth_mk_medianWidth	Shape feature - median of  Width of tooth marks
tooth_mk_medianWidth_rela	Shape feature - median of  Relative Aspect Ratio of tooth marks
tooth_mk_medianHeight	Shape feature - median of  Height of tooth marks
tooth_mk_medianHeight_rela	Shape feature - median of  Relative Height of tooth marks
tooth_mk_medianW_H	Shape feature - median of  Aspect Ratio of tooth marks
tooth_mk_medianDiagonal	Shape feature - median of  Diagonal Length of tooth marks
tooth_mk_medianArea	Shape feature - median of  Area of tooth marks
tooth_mk_medianArea_rela	Shape feature - median of  Relative Area of tooth marks
tooth_mk_varWidth	Shape feature - Variance of Width of tooth marks
tooth_mk_varWidth_rela	Shape feature - Variance of Relative Width of tooth marks
tooth_mk_varHeight	Shape feature - Variance of Height of tooth marks
tooth_mk_varHeight_rela	Shape feature - Variance of Relative Height of tooth marks
tooth_mk_varW_H	Shape feature - Variance of Aspect Ratio of tooth marks
tooth_mk_varDiagonal	Shape feature - Variance of Diagonal Length of tooth marks
tooth_mk_varArea	Shape feature - Variance of Area of tooth marks
tooth_mk_varArea_rela	Shape feature - Variance of Relative Area of tooth marks
tooth_mk_sumWidth	Shape feature - Total Width Length of tooth marks
tooth_mk_sumWidth_rela	Shape feature - Total Relative Width Length of tooth marks
tooth_mk_sumHeight	Shape feature - Total Height Length of tooth marks
tooth_mk_sumHeight_rela	Shape feature - Total Relative Height Length of tooth marks
tooth_mk_sumDiagonal	Shape feature - Total Diagonal Length of tooth marks
tooth_mk_sumArea	Shape feature - Total Area of tooth marks
tooth_mk_sumArea_rela	Shape feature - Total Relative Area of tooth marks
tooth_mk_cnnPC1	CNN feature - CNN Feature PC1 of tooth marks
tooth_mk_cnnPC2	CNN feature - CNN Feature PC2 of tooth marks
tooth_mk_cnnPC3	CNN feature - CNN Feature PC3 of tooth marks
tooth_mk_cnnPC4	CNN feature - CNN Feature PC4 of tooth marks
tooth_mk_cnnPC5	CNN feature - CNN Feature PC5 of tooth marks
tooth_mk_cnnPC6	CNN feature - CNN Feature PC6 of tooth marks
tooth_mk_cnnPC7	CNN feature - CNN Feature PC7 of tooth marks
tooth_mk_cnnPC8	CNN feature - CNN Feature PC8 of tooth marks
tooth_mk_cnnPC9	CNN feature - CNN Feature PC9 of tooth marks
tooth_mk_cnnPC10	CNN feature - CNN Feature PC10 of tooth marks
